"filename", "language", "TypeScript", "JavaScript", "comment", "blank", "total"
"/Users/akshaysharma/projects/sabpaisa/sabpaisa-npm/lib/components/Button/Button.d.ts", "TypeScript", -11, 0, -18, -1, -30
"/Users/akshaysharma/projects/sabpaisa/sabpaisa-npm/lib/components/Button/Button.stories.d.ts", "TypeScript", -7, 0, 0, -1, -8
"/Users/akshaysharma/projects/sabpaisa/sabpaisa-npm/lib/components/Button/index.d.ts", "TypeScript", -1, 0, 0, -1, -2
"/Users/akshaysharma/projects/sabpaisa/sabpaisa-npm/lib/components/PaymentInitModal/ContactInformation.d.ts", "TypeScript", -13, 0, -18, -1, -32
"/Users/akshaysharma/projects/sabpaisa/sabpaisa-npm/lib/components/PaymentInitModal/PaymentInitModal.stories.d.ts", "TypeScript", -6, 0, 0, -1, -7
"/Users/akshaysharma/projects/sabpaisa/sabpaisa-npm/lib/components/PaymentInitModal/Pg.d.ts", "TypeScript", -61, 0, 0, -1, -62
"/Users/akshaysharma/projects/sabpaisa/sabpaisa-npm/lib/components/PaymentInitModal/Sections/ClientDetails.d.ts", "TypeScript", -52, 0, 0, -1, -53
"/Users/akshaysharma/projects/sabpaisa/sabpaisa-npm/lib/components/PaymentInitModal/index.d.ts", "TypeScript", -1, 0, 0, -1, -2
"/Users/akshaysharma/projects/sabpaisa/sabpaisa-npm/lib/components/PaymentModal/ContactInformation.d.ts", "TypeScript", -13, 0, -18, -1, -32
"/Users/akshaysharma/projects/sabpaisa/sabpaisa-npm/lib/components/PaymentModal/PaymentModal.stories.d.ts", "TypeScript", -6, 0, 0, -1, -7
"/Users/akshaysharma/projects/sabpaisa/sabpaisa-npm/lib/components/PaymentModal/Pg.d.ts", "TypeScript", -33, 0, 0, -1, -34
"/Users/akshaysharma/projects/sabpaisa/sabpaisa-npm/lib/components/PaymentModal/Sections/BHIMUpiQr.d.ts", "TypeScript", -27, 0, 0, -1, -28
"/Users/akshaysharma/projects/sabpaisa/sabpaisa-npm/lib/components/PaymentModal/Sections/BankRedirect.d.ts", "TypeScript", -10, 0, 0, -1, -11
"/Users/akshaysharma/projects/sabpaisa/sabpaisa-npm/lib/components/PaymentModal/Sections/CVV.d.ts", "TypeScript", -10, 0, 0, -1, -11
"/Users/akshaysharma/projects/sabpaisa/sabpaisa-npm/lib/components/PaymentModal/Sections/CancelPayment.d.ts", "TypeScript", -10, 0, 0, -1, -11
"/Users/akshaysharma/projects/sabpaisa/sabpaisa-npm/lib/components/PaymentModal/Sections/CardDetails.d.ts", "TypeScript", -42, 0, 0, -1, -43
"/Users/akshaysharma/projects/sabpaisa/sabpaisa-npm/lib/components/PaymentModal/Sections/Cash.d.ts", "TypeScript", -28, 0, 0, -1, -29
"/Users/akshaysharma/projects/sabpaisa/sabpaisa-npm/lib/components/PaymentModal/Sections/ClientDetails.d.ts", "TypeScript", -17, 0, 0, -1, -18
"/Users/akshaysharma/projects/sabpaisa/sabpaisa-npm/lib/components/PaymentModal/Sections/DebitCardDetails.d.ts", "TypeScript", -38, 0, 0, -1, -39
"/Users/akshaysharma/projects/sabpaisa/sabpaisa-npm/lib/components/PaymentModal/Sections/Emi.d.ts", "TypeScript", -14, 0, 0, -1, -15
"/Users/akshaysharma/projects/sabpaisa/sabpaisa-npm/lib/components/PaymentModal/Sections/EmiCardDetails.d.ts", "TypeScript", -10, 0, 0, -1, -11
"/Users/akshaysharma/projects/sabpaisa/sabpaisa-npm/lib/components/PaymentModal/Sections/Imps.d.ts", "TypeScript", -28, 0, 0, -1, -29
"/Users/akshaysharma/projects/sabpaisa/sabpaisa-npm/lib/components/PaymentModal/Sections/Layouts/PaymentLayout.d.ts", "TypeScript", -12, 0, 0, -1, -13
"/Users/akshaysharma/projects/sabpaisa/sabpaisa-npm/lib/components/PaymentModal/Sections/Layouts/ToastContainer.d.ts", "TypeScript", -3, 0, -1, -1, -5
"/Users/akshaysharma/projects/sabpaisa/sabpaisa-npm/lib/components/PaymentModal/Sections/Layouts/ToastMessage.d.ts", "TypeScript", -2, 0, -1, -1, -4
"/Users/akshaysharma/projects/sabpaisa/sabpaisa-npm/lib/components/PaymentModal/Sections/Neft.d.ts", "TypeScript", -28, 0, 0, -1, -29
"/Users/akshaysharma/projects/sabpaisa/sabpaisa-npm/lib/components/PaymentModal/Sections/NetBanking.d.ts", "TypeScript", -28, 0, 0, -1, -29
"/Users/akshaysharma/projects/sabpaisa/sabpaisa-npm/lib/components/PaymentModal/Sections/OtherMethods.d.ts", "TypeScript", -15, 0, 0, -1, -16
"/Users/akshaysharma/projects/sabpaisa/sabpaisa-npm/lib/components/PaymentModal/Sections/PaymentError.d.ts", "TypeScript", -10, 0, 0, -1, -11
"/Users/akshaysharma/projects/sabpaisa/sabpaisa-npm/lib/components/PaymentModal/Sections/PaymentFailed.d.ts", "TypeScript", -12, 0, 0, -1, -13
"/Users/akshaysharma/projects/sabpaisa/sabpaisa-npm/lib/components/PaymentModal/Sections/PaymentMethod.d.ts", "TypeScript", -14, 0, 0, -1, -15
"/Users/akshaysharma/projects/sabpaisa/sabpaisa-npm/lib/components/PaymentModal/Sections/PaymentProcessing.d.ts", "TypeScript", -10, 0, 0, -1, -11
"/Users/akshaysharma/projects/sabpaisa/sabpaisa-npm/lib/components/PaymentModal/Sections/PaymentSuccess.d.ts", "TypeScript", -10, 0, 0, -1, -11
"/Users/akshaysharma/projects/sabpaisa/sabpaisa-npm/lib/components/PaymentModal/Sections/QrLoader.d.ts", "TypeScript", -10, 0, 0, -1, -11
"/Users/akshaysharma/projects/sabpaisa/sabpaisa-npm/lib/components/PaymentModal/Sections/QrScreen.d.ts", "TypeScript", -10, 0, 0, -1, -11
"/Users/akshaysharma/projects/sabpaisa/sabpaisa-npm/lib/components/PaymentModal/Sections/RequestTimeout.d.ts", "TypeScript", -10, 0, 0, -1, -11
"/Users/akshaysharma/projects/sabpaisa/sabpaisa-npm/lib/components/PaymentModal/Sections/Rtgs.d.ts", "TypeScript", -28, 0, 0, -1, -29
"/Users/akshaysharma/projects/sabpaisa/sabpaisa-npm/lib/components/PaymentModal/Sections/RupayCardDetails.d.ts", "TypeScript", -40, 0, 0, -1, -41
"/Users/akshaysharma/projects/sabpaisa/sabpaisa-npm/lib/components/PaymentModal/Sections/SavedCard.d.ts", "TypeScript", -10, 0, 0, -1, -11
"/Users/akshaysharma/projects/sabpaisa/sabpaisa-npm/lib/components/PaymentModal/Sections/SavedCardCheckout.d.ts", "TypeScript", -10, 0, 0, -1, -11
"/Users/akshaysharma/projects/sabpaisa/sabpaisa-npm/lib/components/PaymentModal/Sections/SelectEmi.d.ts", "TypeScript", -14, 0, 0, -1, -15
"/Users/akshaysharma/projects/sabpaisa/sabpaisa-npm/lib/components/PaymentModal/Sections/UpiMethods.d.ts", "TypeScript", -26, 0, 0, -1, -27
"/Users/akshaysharma/projects/sabpaisa/sabpaisa-npm/lib/components/PaymentModal/Sections/UpiPaymentProcessing.d.ts", "TypeScript", -10, 0, 0, -1, -11
"/Users/akshaysharma/projects/sabpaisa/sabpaisa-npm/lib/components/PaymentModal/Sections/Wallet.d.ts", "TypeScript", -26, 0, 0, -1, -27
"/Users/akshaysharma/projects/sabpaisa/sabpaisa-npm/lib/components/PaymentModal/index.d.ts", "TypeScript", -1, 0, 0, -1, -2
"/Users/akshaysharma/projects/sabpaisa/sabpaisa-npm/lib/constants/regex.d.ts", "TypeScript", -1, 0, 0, -1, -2
"/Users/akshaysharma/projects/sabpaisa/sabpaisa-npm/lib/helpers/common-helper.d.ts", "TypeScript", -8, 0, 0, -1, -9
"/Users/akshaysharma/projects/sabpaisa/sabpaisa-npm/lib/helpers/finance-helper.d.ts", "TypeScript", -3, 0, 0, -1, -4
"/Users/akshaysharma/projects/sabpaisa/sabpaisa-npm/lib/index.d.ts", "TypeScript", -4, 0, 0, -1, -5
"/Users/akshaysharma/projects/sabpaisa/sabpaisa-npm/lib/index.esm.js", "JavaScript", 0, -11057, -3202, -2362, -16621
"/Users/akshaysharma/projects/sabpaisa/sabpaisa-npm/lib/index.js", "JavaScript", 0, -11080, -3202, -2367, -16649
"/Users/akshaysharma/projects/sabpaisa/sabpaisa-npm/lib/services/Models/sabpaisa-payment-types.d.ts", "TypeScript", -174, 0, 0, -1, -175
"/Users/akshaysharma/projects/sabpaisa/sabpaisa-npm/lib/services/http-common.d.ts", "TypeScript", -6, 0, 0, -1, -7
"/Users/akshaysharma/projects/sabpaisa/sabpaisa-npm/lib/services/sabpaisa-service.d.ts", "TypeScript", -16, 0, 0, -1, -17
"/Users/akshaysharma/projects/sabpaisa/sabpaisa-npm/lib/utils/cardTypes.d.ts", "TypeScript", -39, 0, 0, -1, -40
"/Users/akshaysharma/projects/sabpaisa/sabpaisa-npm/lib/utils/formatter.d.ts", "TypeScript", -2, 0, 0, -1, -3
"/Users/akshaysharma/projects/sabpaisa/sabpaisa-npm/lib/utils/index.d.ts", "TypeScript", -12, 0, 0, -1, -13
"Total", "-", -1042, -22137, -6460, -4784, -34423